ACE = Angew. Chem. Int. Ed. Engl.,Angewandte Chemie International Edition in English
ACP = Adv. Chem. Phys., Advances in Chemical Physics
ACR = Acc. Chem. Res., Accounts of Chemical Research
ACSN = ACS Nano
ACSP = ACS Photonics
ADP = Ann. Phys., Annalen der Physik
AJP = Am. J. Phys., American Journal of Physics
AM = Adv. Mater., Advanced Materials
AMI = Appl. Mater. Interfaces, Applied Materials and Interfaces
AMR = Adv. Magn. Reson., Advances in Magnetic Resonance
AOM = Adv. Opt. Mater., Advanced Optical Materials
AP = Ann. Phys., Annalen der Physik
APL = Ann. Phys. (Leipzig), Annalen der Physik
APhL = Appl. Phys. Lett., Applied Physics Letters
AQC = Adv. Quantum Chem., Advances in Quantum Chemistry
ARPC = Annu. Rev. Phys. Chem., Annual Review of Physical Chemistry
ASpec = Appl. Spectrosc., Applied Spectroscopy
AdP = Ann. Phys. (Berlin), Annalen der Physik
BBA = Biochim. Biophys. Acta, Biochimica et Biophysica Acta
BC = Biochemistry
BJ = Biophys. J., Biophysical Journal
BP = Biopolymers
CEJ = Chem. Eur. J., Chemistry: A European Journal
CP = Chem. Phys., Chemical Physics
CPC = Comp. Phys. Comm., Computer Physics Communications
CPL = Chem. Phys. Lett., Chemical Physics Letters
CR = Chem. Rev., Chemical Reviews
CSR = Chem. Soc. Rev., Chemical Society Reviews
CST = Compos. Sci. Technol., Composites Science and Technology
EPL = Europhys. Lett., Europhysics Letters
FD = Faraday Discuss., Faraday Discussions
IJC = Israel J. Chem., Israeli Journal of Chemistry
IJQC = Int. J. Quant. Chem., International Journal of Quantum Chemistry
JACS = J. Am. Chem. Soc., Journal of the American Chemical Society
JAIDS = J. Acquir. Immune Defic. Syndr., Journal of Acquired Immune Deficiency Syndromes
JAP = J. Appl. Phys., Journal of Applied Physics
JCC = J. Comput. Chem., Journal of Computational Chemistry
JCCryst = J. Chem. Cryst., Journal of Chemical Crystallography
JCP = J. Chem. Phys., The Journal of Chemical Physics
JCTC = J. Chem. Theor. Comput., Journal of Chemical Theory and Computation
JCoP = J. Comput. Phys., Journal of Computational Physics
JES = J. Electrochem. Soc., Journal of the Electrochemical Society
JMB = J. Mol. Biol., Journal of Molecular Biology
JMC = J. Med. Chem., Journal of Medicinal Chemistry
JMP = J. Math. Phys., Journal of Mathematical Physics
JMS = J. Mol. Struct., Journal of Molecular Structure
JOC = J. Org. Chem., The Journal of Organic Chemistry
JOSAB = J. Opt. Soc. Am. B, Journal of the Optical Society of America B
JPB = J. Phys. B, Journal of Physics B: Atomic, Molecular and Optical Physics
JPC = J. Phys. Chem., The Journal of Physical Chemistry
JPCA = J. Phys. Chem. A, The Journal of Physical Chemistry A
JPCB = J. Phys. Chem. B, The Journal of Physical Chemistry B
JPCC = J. Phys. Chem. C, The Journal of Physical Chemistry C
JPCL = J. Phys. Chem. Lett., The Journal of Physical Chemistry Letters
JPPA = J. Photochem. Photobiol., Journal of Photochemistry and Photobiology A
JPPB = J. Photochem. Photobiol., Journal of Photochemistry and Photobiology B
JPSJ = J. Phys. Soc. Japan, The Journal of the Physical Society of Japan
JRS = J. Raman Spectrosc., Journal of Raman Spectroscopy
JSM = J. Sov. Math., Journal of Soviet Mathematics
JSQE = IEEE J. Sel. Top. Quantum Electron., IEEE Journal of Selected Topics in Quantum Electronics
JTA = J. Thermal Anal., Journal of Thermal Analysis and Calorimetry
LMP = Lett. Math. Phys., Letters in Mathematical Physics
MME = Macromol. Mater. Eng., Macromolecular Materials and Engineering
MP = Mol. Phys., Molecular Physics
N = Nature
NC = Nat. Chem., Nature Chemistry
NCOM = Nat. Commun., Nature Communications
NCTL = Nachr. Chem. Tech. Lab, Nachrichten aus Chemie, Technik und Laboratorium
NJP = New J. Phys., New Journal of Physics
NL = Nano Lett., Nano Letters
NMat = Nat. Mater., Nature Materials
NN = Nat. Nanotech., Nature Nanotechnology
NP = Nature Photon., Nature Photonics
NPH = Nat. Phys., Nature Physics
OE = Opt. Express, Optics Express
P = Proteins
PA = Physica A
PCCP = Phys. Chem. Chem. Phys., Physical Chemistry Chemical Physics
PCPS = Proc. Camb. Philos. Soc., Proceedings of the Cambridge Philosophical Society
PE = Physica E
PMS = Prog. Mater. Sci., Progress in Materials Science
PNAS = Proc. Natl. Acad. Sci. USA, Proceedings of the National Academy of Sciences
PPSC = Part. Part. Syst. Charact., Particle & Particle Systems Characterization
PR = Phys. Rev., Physical Review
PRA = Phys. Rev. A, Physical Review A
PRB = Phys. Rev. B, Physical Review B
PRE = Phys. Rev. E, Physical Review C
PRL = Phys. Rev. Lett., Physical Review Letters
PRS = Proc. R. Soc., Proceedings of the Royal Society
PRSA = Proc. R. Soc. A, , Proceedings of the Royal Society A
PRSL = Proc. R. Soc. Lond., Proceedings of the Royal Society of London
PRSLA = Proc. R. Soc. Lond. A, Proceedings of the Royal Society of London A
PRp = Phys. Rep., Physics Reports
PSSA = Polym. Sci. Ser. A, Polymer Science Series A
PU15 = Ultrafast Phenomena XV, Ultrafast Phenomena XV - Proceedings of the 15th International Conference
PU17 = Ultrafast Phenomena XVII, Ultrafast Phenomena XVII - Proceedings of the 17th International Conference
RMP = Rev. Mod. Phys., Reviews of Modern Physics
S = Science
SM = Soft Matter
SR = Sci. Rep., Scientific Reports
SS = Surf. Sci., Surface Science
SSR = Surf. Sci. Rep., Surface Science Reports
SSS = Solid State Sciences
ZN = Z. Naturforsch.
ZP = Z. Phys., Zeitschrift f{\"u}r Physik
ZPB = Z. Phys. B, Zeitschrift f{\"u}r Physik B
